000000000000000000000000
000000000000000000000000
001111001111110011110000
001111001111110011110000
00000000000E000000000000
110011111100001111110011
110011111100001111110011
000000000000000000000000
00000000000000000G000000
000000000000000000000000
g0000000000000000000000G
110000000000000111110011
110000000000000111110011
000000000000000000000000
00111100111111e011110000
001111001111110011110000
000000000000000000000000
000000000000000000000000