000000000000000000000000
000000000000000000000000
00111g000110e00011110000
001110000110000011110000
000000000000000000000000
110000000000001111G00011
110011111000001111000011
000011111000000000000000
000000000000000000000000
00000000000000000G000000
000000000000001111100000
110011111000001111100000
110011111000000000000000
000000000000000000000000
000000000000000011110000
0E00000G0000000011110000
000000000000000000000000
00000E000000000000000000