g00000000000000000000000
000000000000000000000000
00111100011111100111110E
001111000111111001111100
001111000000000001111100
000000000000000000000000
000000001111011110000000
0011110010G0000E10011100
001111000000000000011100
G01111001000000010011100
000000001111011110000000
000000000000000000000000
001111110011111100111100
001111110G11111100111100
001111110011111100000000
000000000000000000111100
E00011110000111110111100
0000000000000000000000e0